111111111111111111111111111111
100000000000000000000000000001
101111011111011111011111011101
100001000001000001000001000001
111101111101111101111101111101
100100000100000100000100000001
101101110111110111110111110101
100001010000010000010000010001
111101011111011111011111011101
100001000001000001000001000001
101111011111011111011111011101
100000010000000000000010000001
111111011111011111011111011111
100000000000010000000000000001
101111111111010111111111111101
100000000001000100000000000001
111101111101111101111101111101
100001000001000001000001000001
101101110111110111110111110101
1000010000000N0000000000000001
111111111111111111111111111111