NO ./textures/north.xpm
SO ./textures/south.xpm
WE ./textures/west.xpm
EA ./textures/east.xpm

F 100,,0
C 225,30,0

11111
10001
100N1
10001
11111